1111111111111111111111
1E000WW00000000C00W0E1
1010010100100W00101M01
1010010010101010001001
1010010010101010001001
10100100101F1010001001
1010010010101010001001
1010010010101010001001
1010010010101010001001
1P0000000C00C00000W001
1111111111111111111111
