1111111111111111111111
1E00000000000W0C0000E1
1010010100100000101001
1000001000000000000001
10000M0000F00000000001
1000000000000000100001
1010W10010101010001001
1P0000000C00C00000W001
1111111111111111111111
