1111111111111111111111
1E00000000000W0C0W00E1
1010010100100000101001
10W000100000W0000W0001
10W00M0000F0000000W001
100000000000W000100001
1010W10010101010001001
1P0000000C00C00000W001
1111111111111111111111
