1111111111111111111111
100E000000001000000001
1111111111111000000001
1000P00000001000000001
1000000000001000000001
10000000C0001000000001
1000000000001000000001
1000000000000000000001
1000000000000000000001
1111111111111111111111
